220000220010101
210100000000000
222000200010101
210120022000000
000000220010101
010100002000000
000000220000000
000000022001010
101010222000000
000000222001010
101010022000002
220000222001012
101010222000022